{
0;0;0;0;0;0;0
0;0;0;0;0;0;0
0;0;0;0;0;0;0
0;3;0;2;0;1;0
0;0;0;0;0;0;0
0;0;0;0;4;0;0
0;0;0;0;0;0;0
}
{
2;0;0;0;0;0;0
0;0;0;0;4;0;0
0;0;0;0;0;0;0
33;3;0;2;0;1;0
0;0;0;0;0;0;0
0;0;0;0;0;0;0
0;0;0;0;0;0;0
}
{
0;0;0;0;0;0;0
0;31;0;0;0;2;0
0;0;4;2;0;3;0
0;0;0;0;0;0;0
0;2;3;0;0;1;0
0;0;0;0;0;2;0
0;0;0;0;0;0;0
}
{
0;0;33;0;0;0;0
0;2;0;0;0;0;0
0;0;0;0;0;3;0
0;3;0;0;0;1;2
0;4;0;0;0;2;0
0;0;2;0;0;0;0
0;0;0;0;0;0;0
}
{
0;0;0;0;0;0;0
0;2;3;0;0;0;0
0;4;0;0;0;0;2
0;0;0;0;1;2;3
3;0;2;0;0;3;0
2;0;0;0;0;0;0
0;0;0;0;0;0;0
}
{
0;0;0;0;0;2;0
0;2;0;0;0;0;0
0;1;0;0;0;0;0
0;0;0;0;0;0;0
0;3;0;0;3;2;4
0;0;0;0;2;0;0
0;0;0;0;3;0;0
}